Room 2.txt
A: 9 V: 3 
A: 9 V: 5 
A: 5 V: 3 
A: 5 V: 5 
A: 3 V: 3 
A: 5 V: 5 
A: 5 V: 5 
A: 5 V: 5 