Room 1.txt
A: 4 V: 2 
A: 9 V: 7 
A: 9 V: 5 
A: 5 V: 5 
A: 1 V: 5 